┌─────────────────────┐
│·····················│
│·····················│
?··········¥··········│
│·····················│
│·····················│
└─────────────────────┘