┌─────────────────────┐                            
│·····················│                            
│·····················│                            
│·····················│                            
│·····················│               ┌───────────┐
│·····················│               §···········│
│·····················│               │···········│
│·····················│               │···········│
│·····················§               │···········│
│·····················│               │···········│
│·····················│               │···········│
│·····················│               │···········│
│·····················│               └────────§──┘
│·····················│                            
│·····················│                            
└─────────────────────┘                            